########
#    p #
# ...  #
# ooo  #
#      #
########
